-1 -1;-6 -2;-5 2;-3 2;-4 0
6 5;1 2;2 -4;5 -2;4 1
0 -3;-5 -4;-5 -5;1 -5;0 -4
7 6;0 4;-5 6;0 6;4 7
8 8;8 -7;9 -8;9 9
8 8;-7 8;-8 9;9 9
-7 8;-7 -7;-8 -8;-8 9
8 -7;-7 -7;-8 -8;9 -8
